██╗  ██╗██╗
██║  ██║██║
███████║██║
██╔══██║██║
██║  ██║██║
╚═╝  ╚═╝╚═╝
